6 16 16 1 4 4 4 4 4 4 4 3 16 16 6
7 16 16 7 16 15 16 15 16 15 16 7 16 16 7
7 16 16 5 16 15 16 15 16 15 16 5 16 16 7
7 16 16 16 16 16 16 16 16 16 16 16 16 16 7 
7 16 16 16 16 16 16 16 16 16 16 16 16 16 7
7 16 16 16 16 16 16 16 16 16 16 16 16 16 7
7 16 16 15 16 15 16 15 16 15 16 15 16 16 7
7 16 16 15 16 15 16 15 16 15 16 15 16 16 7
7 16 16 11 14 13 14 13 14 13 14 9 16 16 7
7 16 16 10 14 12 14 12 14 12 14 8 16 16 7
7 16 16 15 16 15 16 15 16 15 16 15 16 16 7
7 16 16 15 16 15 16 15 16 15 16 15 16 16 7
7 16 16 16 16 16 16 16 16 16 16 16 16 16 7
7 16 16 16 16 16 16 16 16 16 16 16 16 16 7
7 16 16 16 16 16 16 16 16 16 16 16 16 16 7
7 15 16 15 16 15 16 15 16 15 16 15 16 15 7
7 15 16 15 16 15 16 15 16 15 16 15 16 15 7
0 4 4 4 4 4 4 4 4 4 4 4 4 4 2
